###### NE PAS MODIFIER LA MIS EN PAGE ######
level=1
nb_largeur=10
nb_hauteur=10
Time_Limit(s)=60
########## CODE GENERANT LA CARTE ########
3#1#1#0#1#1#1#1#1#4
1#1#1#0#1#1#1#1#1#1
1#1#1#0#1#1#1#1#1#1
1#1#1#0#1#1#1#1#1#1
1#1#1#1#1#1#1#1#1#1
1#1#1#1#1#1#1#1#1#1
1#1#1#1#1#1#1#1#1#1
1#1#1#1#1#0#0#0#0#1
1#1#1#1#1#1#1#1#0#1
4#1#1#1#1#1#1#1#0#5